



111111
100001
100001
110001
 11101
   111