C 10,20,33
F 10,4,24

NO textures/5_wall.xpm
EA textures/2_wall.xpm
SO textures/3_wall.xpm
WE textures/4_wall.xpm

    11111111111
    10000000001111
    100001000001
    10001 10000111
    100001001001
    100011001001
    1000001S1001
    1010001010011
    10000010100111
    1111111111111
