
C 25,100,200
F 10,122,24

NO textures/5_wall.xpm
EA textures/2_wall.xpm
SO textures/3_wall.xpm
WE textures/4_wall.xpm


11111111111
10000000001111
100001000001
10001 1000111
100001001001
100011001001
100000111001
1010W1010111
10000010100111
1111111111111111
