



    111111111111   
    10000000000111111111111111111111
    100000000001
    10000000000111111111111111111111111111111111111111111111111111111111111111111111
    100000000001
    100011000001                                                                             
    100000000001                                                                
    100000000001111111111111111111111111111111111111111111111111111    
    10000000000111111110111111111111111111111111111111111111111111111111111
    1111111111111111111111111111111111111111111111111111111111