C 10,20,33
F 10,4,24

NO textures/1_wall.xpm
EA textures/2_wall.xpm
SO textures/3_wall.xpm
WE textures/4_wall.xpm

    11111111111   
    10000000001111
    100001000001
    10001 10000111
    100001000001
    100011000001    
    1000000N0001 
    1010000010011111111             
    10000000000111
    11111111111111111
