



    11111111111   
    1000000000111111111111111111111
    100001000001
    10001 10000111111111111111111111111111111111111111111111111111111111111111111111
    100001000001
    100011000001                                                                             
1   100000000001                                                                
    101000000001111111111111111111111111111111111111111111111111111    
    10000000000111111110111111111111111111111111111111111111111111111111111
    1111111111111111111111111111111111111111111111111111111111