C     25,    100,       200   


NO              textures/5_wall.xpm              
EA              textures/2_wall.xpm             

F 10,   122,24  

SO   textures/3_wall.xpm   
WE    textures/4_wall.xpm
SALUT
                                  
11111111111
10000000001111
100001000001
10001 1000111
100001001001
100011001001
100000111001
101001010111
10000010100111
1111111111111111