
C     25,    100,       200   
NO              textures/5_wall.xpm              
EA              textures/2_wall.xpm             
F 10,   122,24  








 




  

   


    


SO   textures/3_wall.xpm   
WE    textures/4_wall.xpm

                                  
1111111111111111111111111111111111111111
1000000000000000000000000000000000000001
1000000000000000000000000000000000000001
100000000000000000N000000000000000000001
1000000000000000000000000000000000000001
1000000000000000000000000000001000000001
1000000000000000001111100000000000000001
1000000000000000001   100000000000000001
1000000000000000001   100000000000000001               
1000000000000000001111100000000000000001 
1000000000000000000000000000000000000001
1000000000000000000000000000000000000001
1000000000000000000000000000010000000001
1000000000000000000000000000000000000001
1111111111111110000001111000111100100111
1111111111111111110111111000000000000011
1111111111111111110111111111111111111111
1111100000000000000000000000000111111111
1000000000000000000000000000000000000001
1000000000000000000000000000000000000001
1000000000000000000000000000000000000001
1000000000000000000000000000000000000001
1000000000000000000000000000000000000001
1111111111111111111111111111111111111111