NO              textures/5_wall.xpm              
EA              textures/2_wall.xpm             
C 0,0,0
F 0,0,0
SO   textures/3_wall.xpm   
WE    textures/4_wall.xpm
11111111111111111111111111111111111111111111111111111111111111111111111111111111111111111111111111111111111111111111111111111111111111111
1N111111111111111111111111111111111111111111111111111111111111111111111111111111111111111111111111111111111111111111111111111111111111111   
10111111111111111111111111111111111111111111111111111111111111111111111111111111111111111111111111111111111111111111111111111111111111111   
10111111111111111111111111111111111111111111111111111111111111111111111111111111111111111111111111111111111111111111111111111111111111111
101  
101
101
101 
101  
101
101
101
101  
101
101
101
101  
101
101
101
101  
101
101
101
101  
101
101
101 
101  
101
101
101
101  
101
101
101
101  
101
101
101
101  
101
101
101
101  
101
101
101 
101  
101
101
101
101  
101
101
101
101  
101
101
101
101  
101
101
101
101  
101
101
101 
101  
101
101
101
101  
101
101
101
101  
101
101
101
101  
101
101
101
101  
101
101
101 
101  
101
101
101
101  
101
101
101
101  
101
101
101
101  
101
101
101
111
111
111
111
11
111
1111
11111
1111111      
